F
10
10
AAAAAAAAAA
A        A
A        A
A  22222 A
A  2EGR2 A
A  22@22 A
A        A
A 2      A
A 3      A
AAAAAAAAAA