J
10
10
3333333333
3        3
3   3    3
3  3O3   3
3  @RS3  3
3    3   3
3        3
3        3
3        3
3333333333
