F
10
10
AAAAAAAAAA
A        A
A        A
A @      A
A   MH   A
A  MEM   A
A   B    A
A 2      A
A 3      A
AAAAAAAAAA